13 31
###############################
#p * *1       *  ** * *      *#
# # # # #*# # #*# # # # # #*# #
#    * * *** **  1   *    **  #
# #*# # # # #1# #b#1# # # # #*#
#          *     **      *  **#
# # #*# # # # # #*#*#*#*# # # #
#   *        *   * *1* *   1  #
# # # # #*# # # # # # #*# #*# #
#   ****         *1           #
# # # # # # # # # #*# # # # #*#
#  ** *1  *    1              #
###############################