13 31
###############################
#p i *1       *  ** * *      *#
# # # # #*# # #*# # # # # #*# #
#    i * *i* **  1   *    **  #
# #i# # # # #1# #b#1# # # # #*#
#          *     **      *  **#
# # #*# # # # # #*#*#*#*# # # #
#   i        *   * *1* *   1  #
# # # # #*# # # # # # #*# #*# #
#   i***         *1           #
# # # # # # # # # #*# # # # #*#
#  i* *1  *    1              #
###############################